0000000000000000000000000
0000000000000000000000000
0000000000000000000000000
0000000000000000000000005
0000000000000000000000000
0000000000000000000000002
0000000000000000000000000
9000000000000000000000007
2000000000000000000000000
0007900000000000000079000
0000000000788890000000000
0000000000000000000000002
0000000000000000000000000
9000000790000000790000007
2000000000000000000000000
0000000000000000000000000
0078890000788890000788900
5000000000000000000000000
0000000000000000000000000
6666666666666666666666666
6666666666666666666666666
